Accuracy: 0.241

Ratio of tags of incorrectly generated inflections: 
N: 0.8351351351351352
ACC: 0.7352941176470589
SG: 0.7288732394366197
ADJ: 0.6138328530259366
NEUT: 0.6823529411764706
LGSPEC1: 0.967741935483871
DAT: 0.8229166666666666
PL: 0.8282548476454293
NOM: 0.6526315789473685
FEM: 0.6597938144329897
MASC: 0.4608695652173913
V: 0.8387096774193549
FUT: 1.0
3: 1.0
V.CVB: 0.9259259259259259
PST: 0.6790123456790124
PRS: 0.9402985074626866
1: 0.9259259259259259
ESS: 0.712
IMP: 0.9411764705882353
2: 0.9722222222222222
GEN: 0.7333333333333333
INS: 0.6747967479674797
ANIM: 0.375
INAN: 0.6428571428571429
V.PTCP: 0.7692307692307693
ACT: 0.5714285714285714
PASS: 1.0

Incorrect words: 
галиотис	N;ACC;SG
первобытный	ADJ;NEUT;SG;LGSPEC1
россыпь	N;DAT;PL
представительница	N;NOM;PL
быстрота	N;DAT;SG
пульсар	N;ACC;PL
разлад	N;NOM;SG
подвижной	ADJ;ACC;FEM;SG
болтун	N;DAT;PL
купальный халат	N;NOM;PL
средний	ADJ;DAT;MASC;SG
подвесить	V;FUT;3;PL
повышенный	ADJ;NOM;PL
напитать	V;CVB;PST
ускользать	V;PRS;1;SG
проявление	N;ESS;PL
классная доска	N;ESS;PL
разламывать	V;IMP;2;SG
комендант	N;GEN;PL
фарерский	ADJ;INS;NEUT;SG
поруководить	V;CVB;PST
жаворонок	N;ACC;SG
недосягаемый	ADJ;ACC;ANIM;PL
высокоскоростной	ADJ;ESS;NEUT;SG
делишки	N;DAT;SG
дурачиться	V;CVB;PST
взмах	N;GEN;PL
застирать	V;FUT;3;SG
сенатский	ADJ;DAT;MASC;SG
выплачиваться	V;IMP;2;SG
люк фотопулемёта	N;NOM;PL
пищевой	ADJ;DAT;FEM;SG
неловкий	ADJ;NOM;PL
отделять	V;FUT;1;SG
преступный	ADJ;FEM;SG;LGSPEC1
мадера	N;ACC;PL
невинный	ADJ;ACC;INAN;PL
потрёпанный	ADJ;ACC;INAN;PL
добивать	V;PRS;1;SG
беспорядочный	ADJ;ANIM;ACC;MASC;SG
краевой	ADJ;DAT;NEUT;SG
плясать	V;PRS;2;SG
порасти	V;PST;SG;FEM
бомбист	N;ACC;SG
кототерапия	N;GEN;SG
хаять	V;PST;SG;FEM
камчатский	ADJ;ACC;INAN;PL
здравомыслие	N;GEN;PL
влажность	N;ACC;SG
блондин	N;INS;SG
стекать	V;FUT;2;SG
партнёрский	ADJ;INS;FEM;SG
сексистский	ADJ;GEN;NEUT;SG
фартовый	ADJ;DAT;PL
геральдика	N;INS;SG
двухлетний	ADJ;ACC;ANIM;PL
гавань	N;ESS;PL
ссака	N;ACC;PL
исламофобия	N;ACC;SG
заполучить	V;IMP;2;PL
жизнедеятельность	N;INS;SG
гаишник	N;INS;SG
подбадривать	V;CVB;PRS
оспаривать	V;FUT;3;PL
парикмахерская	N;GEN;SG
заговориться	V;IMP;2;PL
сухожилие	N;GEN;SG
антисанитарный	ADJ;NOM;PL
австрийка	N;INS;PL
сильное взаимодействие	N;ESS;SG
погреть	V;FUT;1;SG
опубликовывать	V;PRS;1;SG
всаживать	V;FUT;3;SG
присесть	V;PST;SG;FEM
попутешествовать	V;PRS;3;SG
спряжение	N;DAT;PL
Страстной четверг	N;ESS;PL
насаждать	V;PST;SG;MASC
новодевичий	ADJ;ESS;FEM;SG
котяра	N;DAT;SG
горячить	V;FUT;1;SG
утопленный воздухозаборник	N;INS;SG
пользователь	N;INS;SG
топография	N;ACC;SG
блошиный рынок	N;DAT;SG
надоедливый	ADJ;INS;MASC;SG
проистекать	V;FUT;3;PL
ульяновский	ADJ;NOM;FEM;SG
полиграфический	ADJ;INS;PL
вымышлять	V;PST;PL
неофашизм	N;INS;SG
подъезд	N;NOM;SG
костёр	N;ACC;PL
уведомление	N;DAT;PL
ясный	ADJ;ESS;FEM;SG
преполовение	N;GEN;SG
воронко	N;INS;SG
утомлённый	V;PTCP;ESS;MASC;SG
перевозчик	N;DAT;PL
ковёр	N;INS;SG
разглядывать	V;PST;SG;NEUT
асфиксия	N;INS;SG
уравновешенный	ADJ;GEN;FEM;SG
непобедимый	ADJ;INS;MASC;SG
брутальный	ADJ;GEN;PL
ориентированный	V;PTCP;INAN;ACC;MASC;SG
геморрагия	N;NOM;SG
обыгрывать	V;PST;SG;FEM
огнемёт	N;ACC;SG
присмотр	N;ESS;SG
облик	N;GEN;PL
пускаться	V;FUT;1;PL
шок	N;ACC;PL
раскланиваться	V;FUT;2;PL
умывальня	N;DAT;PL
плоть	N;ACC;PL
имитация	N;ACC;PL
анилинкция	N;ACC;PL
обидчивый	ADJ;GEN;FEM;SG
хантыйский	ADJ;INS;MASC;SG
испачкать	V;CVB;PST
смазать	V;FUT;2;SG
лысеть	V;PST;SG;MASC
феноменальный	ADJ;NEUT;SG;LGSPEC1
информатизация	N;DAT;PL
взмывать	V;CVB;PRS
благоухать	V;IMP;2;SG
ипподром	N;NOM;PL
древесный уголь	N;NOM;PL
содомизировать	V;FUT;2;SG
закрытый	ADJ;DAT;NEUT;SG
морской чёрт	N;ESS;SG
связка	N;DAT;SG
угнетение	N;DAT;PL
втискать	V;IMP;2;SG
волосатый	ADJ;NOM;NEUT;SG
маршрутный	ADJ;ANIM;ACC;MASC;SG
уняться	V;IMP;2;SG
дёргаться	V;PTCP;ACT;PST
кентавр	N;GEN;PL
молоденький	ADJ;DAT;FEM;SG
подкрадываться	V;FUT;2;PL
пропорциональность	N;INS;PL
мотель	N;ACC;PL
просочиться	V;FUT;2;PL
промчаться	V;FUT;3;SG
прошлый	ADJ;DAT;NEUT;SG
церебральный	ADJ;MASC;SG;LGSPEC1
фиксированный	V;PTCP;GEN;FEM;SG
вяжущий	ADJ;ACC;FEM;SG
малочисленный	ADJ;NEUT;SG;LGSPEC1
ярмо	N;ESS;SG
совок	N;DAT;PL
фермерский	ADJ;ESS;FEM;SG
шухер	N;NOM;PL
стариться	V;IMP;2;PL
тощий	ADJ;ESS;PL
обстрелять	V;FUT;1;PL
выпячивать	V;PRS;1;SG
освещённый	ADJ;GEN;FEM;SG
новорождённый	N;GEN;SG
аванс	N;GEN;PL
мохнатый	ADJ;NOM;PL
оборванный	ADJ;INS;NEUT;SG
вцепиться	V;FUT;1;SG
навёрстывать	V;PST;SG;MASC
неподдельный	ADJ;PL;LGSPEC1
безмерный	ADJ;PL;LGSPEC1
невежливый	ADJ;FEM;SG;LGSPEC1
державный	ADJ;PL;LGSPEC1
встроенный	ADJ;ACC;INAN;PL
пожилой	ADJ;GEN;FEM;SG
пессимистичный	ADJ;INS;MASC;SG
таец	N;GEN;SG
рысак	N;GEN;PL
омут	N;ESS;PL
колодка	N;GEN;PL
объединённый	ADJ;MASC;SG;LGSPEC1
подвёртываться	V;PTCP;ACT;PRS
свивать	V;FUT;1;SG
адамов	ADJ;ACC;INAN;PL
искусственный отбор	N;ESS;PL
мопед	N;ACC;PL
подглядеть	V;FUT;1;PL
приручаться	V;FUT;2;SG
предсмертный	ADJ;INS;NEUT;SG
избранный	ADJ;ESS;FEM;SG
референдум	N;INS;SG
занятой	ADJ;ACC;NEUT;SG
абсолютистский	ADJ;ACC;ANIM;PL
прибавлять	V;FUT;1;SG
информационно-аналитический	ADJ;INAN;ACC;MASC;SG
разнообразный	ADJ;ESS;NEUT;SG
оруженосец	N;GEN;SG
хулить	V;PTCP;PASS;PRS
прохаживаться	V;CVB;PRS
напаять	V;PTCP;PASS;PST
прицеплять	V;FUT;3;PL
очарованный кварк	N;GEN;PL
конюх	N;INS;SG
колбочка	N;ESS;PL
зашивать	V;FUT;1;SG
долбить	V;IMP;2;SG
вдавливаться	V;FUT;2;SG
сокращённый	V;PTCP;INS;PL
репортаж	N;ESS;PL
психушка	N;GEN;PL
тун	N;INS;SG
надвинуться	V;PST;SG;NEUT
мерзость	N;DAT;SG
кожаный	ADJ;ESS;PL
существительное	N;ESS;SG
белеть	V;PRS;2;PL
мотыжить	V;PRS;1;PL
велосипедистка	N;NOM;SG
беспамятство	N;INS;SG
двухместный	ADJ;GEN;FEM;SG
подверженный	ADJ;PL;LGSPEC1
объёмный	ADJ;INS;MASC;SG
искренний	ADJ;NEUT;SG;LGSPEC1
контактная линза	N;ESS;PL
оплачиваться	V;CVB;PST
производственный	ADJ;INS;MASC;SG
абазинский	ADJ;ACC;NEUT;SG
представляться	V;FUT;2;PL
книжный магазин	N;ACC;PL
лесохозяйственный	ADJ;ACC;FEM;SG
плотный	ADJ;DAT;NEUT;SG
телеведущий	N;GEN;PL
остолбенеть	V;FUT;2;PL
приключение	N;DAT;PL
чёсанок	N;NOM;SG
цельность	N;INS;PL
плескаться	V;CVB;PRS
чемпионский	ADJ;NOM;NEUT;SG
выскакивать	V;PRS;1;SG
камень преткновения	N;ACC;SG
чавкать	V;CVB;PRS
сочетаемый	ADJ;ESS;PL
нестабильность	N;GEN;SG
униженный	ADJ;ACC;FEM;SG
люцерна	N;DAT;SG
гостеприимство	N;ESS;SG
замучиться	V;IMP;2;PL
агностицизм	N;DAT;SG
пульт	N;INS;SG
накоплять	V;CVB;PST
нормальный	ADJ;ESS;PL
правильный глагол	N;GEN;SG
плакать	V;PRS;3;SG
изобретатель	N;ACC;SG
потылица	N;INS;SG
новаторский	ADJ;INS;PL
чемпионка	N;ACC;PL
цыганёнок	N;GEN;SG
куклёнок	N;DAT;SG
продираться	V;PRS;1;SG
заклёпка	N;ACC;SG
опознавать	V;PRS;2;SG
прославленный	V;PTCP;NOM;MASC;SG
гороховый	ADJ;INS;PL
подноготная	N;DAT;SG
астрономическая единица	N;NOM;SG
гумно	N;GEN;PL
сыскать	V;FUT;3;SG
додумывать	V;PRS;1;SG
богатейший	ADJ;INS;FEM;SG
взлохмачивать	V;FUT;3;SG
преследование	N;ESS;PL
почтовый	ADJ;GEN;FEM;SG
уживаться	V;PRS;1;PL
потащиться	V;PTCP;ACT;PST
неотъемлемый	ADJ;ACC;FEM;SG
обмен	N;NOM;PL
напряжённый	V;PTCP;NOM;NEUT;SG
литературовед	N;NOM;PL
сушилка	N;DAT;SG
прорицатель	N;ACC;SG
запечатлевать	V;PRS;3;SG
чавкать	V;PRS;2;SG
алчность	N;DAT;PL
запихать	V;FUT;2;SG
северо-западный	ADJ;GEN;FEM;SG
экстремистский	ADJ;INS;NEUT;SG
форменный	ADJ;ACC;FEM;SG
карп	N;GEN;PL
слабоумный	ADJ;DAT;MASC;SG
канистра	N;ACC;SG
открыться	V;IMP;2;PL
молот	N;INS;SG
акробатика	N;ESS;PL
предпринимательский	ADJ;GEN;PL
гулять	V;PRS;2;PL
калкан	N;ACC;SG
почтовый	ADJ;NOM;NEUT;SG
отвестись	V;CVB;PST
управляемость	N;NOM;SG
спасительный	ADJ;ACC;FEM;SG
усопший	ADJ;ACC;INAN;PL
чёрная дыра	N;ESS;PL
скончаться	V;PST;SG;NEUT
хохотнуть	V;FUT;2;SG
имбирь	N;INS;PL
кончик	N;ACC;PL
растопыривать	V;FUT;1;PL
волшебный	ADJ;ACC;FEM;SG
подобный	ADJ;ACC;INAN;PL
царапина	N;ESS;SG
принятие на себя	N;INS;PL
оборониться	V;IMP;2;PL
ненормальный	ADJ;FEM;SG;LGSPEC1
зыбкий	ADJ;ESS;NEUT;SG
антропоморфный	ADJ;MASC;SG;LGSPEC1
саванна	N;NOM;PL
обмыть	V;FUT;2;SG
приёмник воздушного давления	N;ACC;SG
стукать	V;CVB;PST
дача	N;DAT;SG
стреноживать	V;PTCP;ACT;PRS
запечатлеть	V;FUT;3;PL
прогрессировать	V;FUT;2;PL
плюхаться	V;PRS;2;SG
подступить	V;FUT;2;SG
узаконивать	V;CVB;PRS
влюблять	V;PRS;2;SG
расширяться	V;PRS;1;PL
изумлённый	ADJ;INS;NEUT;SG
проповедь	N;GEN;PL
иерархический	ADJ;NOM;FEM;SG
ломтик	N;INS;SG
приземляться	V;PRS;1;PL
южанин	N;ESS;PL
переговариваться	V;PRS;3;PL
радиолокационный дальномер	N;ESS;PL
благоустраивать	V;PTCP;PASS;PRS
слухи	N;GEN;SG
бухгалтерская книга	N;NOM;PL
взор	N;DAT;PL
очевидец	N;ESS;PL
нидерландка	N;ESS;PL
македонский	ADJ;INS;PL
экскремент	N;ACC;SG
одногорбый	ADJ;INS;PL
авиапредприятие	N;ESS;SG
противопоставлять	V;IMP;2;PL
конский	ADJ;DAT;NEUT;SG
подряд	N;ACC;SG
краповый	ADJ;INS;MASC;SG
обостриться	V;IMP;2;PL
сумасшествовать	V;FUT;1;PL
праща	N;ESS;SG
запутывать	V;IMP;2;SG
раскраснеться	V;FUT;3;PL
геоинформационный	ADJ;ESS;NEUT;SG
десант	N;DAT;PL
делить	V;IMP;2;SG
шрам	N;INS;PL
зародить	V;FUT;2;PL
дрек	N;ACC;SG
высказаться	V;PTCP;ACT;PST
смотреться	V;PRS;3;SG
почуять	V;PST;PL
прикинуться	V;FUT;1;PL
ударный инструмент	N;ACC;PL
организация	N;GEN;SG
цесаревич	N;INS;SG
модуль	N;DAT;SG
мытый	ADJ;MASC;SG;LGSPEC1
обернуть	V;PST;PL
перевёртываться	V;IMP;2;PL
сдёрнуть	V;FUT;2;PL
скорбут	N;ESS;SG
тулий	N;INS;SG
хмурить	V;FUT;2;PL
шизофренический	ADJ;ESS;MASC;SG
цифровой	ADJ;ACC;NEUT;SG
каминг-аут	N;NOM;PL
расхититель	N;ESS;SG
неоспоримый	ADJ;ACC;ANIM;PL
сердить	V;PST;PL
оплести	V;PST;SG;MASC
затылок	N;NOM;PL
обстрел	N;ESS;PL
имущество	N;GEN;SG
британка	N;ACC;PL
темноватый	ADJ;ESS;PL
прибавить	V;PST;PL
гибрид	N;ACC;INAN;PL
монархический	ADJ;NOM;NEUT;SG
кровеносный	ADJ;ACC;ANIM;PL
разрешиться	V;FUT;1;SG
значительный	ADJ;INS;NEUT;SG
ринг	N;DAT;PL
серо-буро-малиновый	ADJ;ANIM;ACC;MASC;SG
водокачка	N;INS;SG
женить	V;PTCP;PASS;PST
кожаный	ADJ;GEN;PL
нейтралитет	N;INS;PL
арменистика	N;ACC;SG
травма	N;ACC;PL
расходовать	V;FUT;3;PL
нацеливать	V;FUT;2;SG
привязь	N;DAT;PL
порнография	N;DAT;PL
усложнение	N;GEN;SG
хулиганить	V;CVB;PRS
покоиться	V;PTCP;ACT;PRS
намотать	V;IMP;2;SG
миро	N;NOM;SG
штатный	ADJ;DAT;NEUT;SG
швеллер	N;ESS;PL
засаживать	V;CVB;PRS
порыв	N;ESS;PL
композиционный	ADJ;GEN;PL
инфинитив	N;GEN;PL
последний	ADJ;DAT;PL
угоститься	V;FUT;2;PL
излишний	ADJ;INS;MASC;SG
пьеса	N;GEN;PL
перископ	N;ESS;PL
бессовестный	ADJ;DAT;MASC;SG
зарубать	V;PTCP;PASS;PRS
знакомство	N;ESS;PL
ост	N;NOM;PL
восторгаться	V;FUT;1;SG
обзывать	V;PRS;1;SG
отыскать	V;PST;SG;MASC
килька	N;GEN;SG
сдвинутый	ADJ;ACC;ANIM;PL
японец	N;GEN;SG
обзаводиться	V;PRS;3;PL
сжиматься	V;FUT;3;PL
оглядывать	V;IMP;2;SG
архимедов	ADJ;DAT;MASC;SG
объявление	N;DAT;PL
правительственный	ADJ;INS;FEM;SG
буддист	N;ACC;PL
машинно-читаемый словарь	N;GEN;SG
переменять	V;PTCP;ACT;PRS
восточноармянский	N;NOM;SG
хаять	V;PTCP;ACT;PST
диез	N;GEN;PL
лист Мёбиуса	N;ESS;SG
славиться	V;PTCP;ACT;PST
тщиться	V;PST;SG;NEUT
полковничиха	N;DAT;SG
безусловный	ADJ;NEUT;SG;LGSPEC1
насчитываться	V;IMP;2;PL
джокер	N;ACC;INAN;PL
щекотать	V;PRS;1;PL
пируэт	N;NOM;SG
любительский	ADJ;INS;PL
перестраиваться	V;CVB;PST
черника	N;DAT;PL
профсоюзница	N;NOM;SG
приподнять	V;CVB;PST
шизофреник	N;INS;SG
противопоставление	N;INS;PL
селянин	N;NOM;PL
подъять	V;PST;SG;NEUT
корейский	ADJ;DAT;MASC;SG
заглядывать	V;PST;SG;MASC
аншлаг	N;ESS;PL
правовой	ADJ;ACC;INAN;PL
треть	N;NOM;PL
засомневаться	V;PST;SG;MASC
дирижировать	V;FUT;1;SG
НЭП	N;GEN;SG
родимое пятно	N;NOM;PL
синтаксический	ADJ;ESS;FEM;SG
мужеложеский	ADJ;DAT;MASC;SG
девица	N;DAT;SG
ислам	N;INS;PL
невыразимый	ADJ;FEM;SG;LGSPEC1
местоименный	ADJ;NOM;PL
столпиться	V;FUT;3;SG
абстинентный синдром	N;GEN;SG
жалобный	ADJ;DAT;NEUT;SG
сместиться	V;PST;SG;NEUT
традиционный	ADJ;ESS;FEM;SG
газон	N;GEN;SG
кликун	N;INS;SG
воспротивиться	V;FUT;1;PL
уполномочивать	V;FUT;1;PL
купля	N;ACC;SG
помолвленный	ADJ;ACC;ANIM;PL
быстрый	ADJ;ESS;FEM;SG
брякать	V;FUT;1;SG
поддельный	ADJ;MASC;SG;LGSPEC1
осведомлять	V;FUT;1;PL
военторг	N;GEN;PL
вонзиться	V;FUT;1;SG
рушник	N;NOM;SG
ограждать	V;PTCP;PASS;PRS
замысел	N;ESS;SG
днюха	N;NOM;PL
авиабригада	N;NOM;SG
смертность	N;NOM;SG
высокогорный	ADJ;INAN;ACC;MASC;SG
пригнуться	V;IMP;2;SG
тяжелобомбардировочный	ADJ;GEN;MASC;SG
Лхаса	N;GEN;SG
сведущий	ADJ;INS;PL
шип	N;ESS;PL
подворотня	N;ACC;SG
отыметь	V;PST;SG;FEM
морозный	ADJ;FEM;SG;LGSPEC1
необходимость	N;ACC;SG
вложить	V;IMP;2;SG
мартышка	N;INS;SG
расположенный	ADJ;ESS;PL
опарыш	N;GEN;PL
обивать	V;FUT;2;SG
теснить	V;FUT;3;PL
гастроль	N;ESS;PL
продаться	V;FUT;1;SG
возница	N;ESS;SG
сбережение	N;NOM;PL
сноб	N;NOM;SG
натуга	N;DAT;SG
фарцовка	N;DAT;SG
поговаривать	V;PRS;3;PL
размышлять	V;PRS;3;SG
ведьма	N;ESS;SG
этиология	N;GEN;SG
зрительский	ADJ;ACC;FEM;SG
сердитый	ADJ;ACC;ANIM;PL
распределённый	V;PTCP;ESS;MASC;SG
прощальный	ADJ;FEM;SG;LGSPEC1
съехаться	V;FUT;2;PL
корейский язык	N;GEN;SG
несогласный	ADJ;GEN;PL
упразднить	V;PST;SG;NEUT
клумба	N;ESS;SG
отваливать	V;CVB;PRS
асинхронный	ADJ;DAT;NEUT;SG
маскировка	N;GEN;PL
административный	ADJ;DAT;PL
эрзянский	ADJ;ACC;FEM;SG
брить	V;PRS;1;PL
новоселье	N;DAT;PL
заочный	ADJ;GEN;PL
продлить	V;FUT;1;PL
ограда	N;GEN;PL
слезоточивый	ADJ;ESS;FEM;SG
барон	N;ACC;SG
битьё	N;INS;SG
балетный	ADJ;GEN;MASC;SG
абстинент	N;INS;PL
грузинский	ADJ;DAT;MASC;SG
грудная клетка	N;ACC;PL
кроить	V;PRS;2;SG
сосудистый	ADJ;DAT;MASC;SG
дополнительный	ADJ;FEM;SG;LGSPEC1
новоиспечённый	ADJ;NEUT;SG;LGSPEC1
завершаться	V;PRS;3;PL
сумасшествие	N;INS;SG
решаться	V;PRS;1;SG
ускориться	V;IMP;2;PL
чокнуться	V;CVB;PST
струп	N;INS;SG
предметный	ADJ;ESS;FEM;SG
применимый	ADJ;FEM;SG;LGSPEC1
оптимист	N;DAT;PL
опаливать	V;PTCP;PASS;PRS
приближать	V;PRS;3;SG
сторонник	N;DAT;PL
разрешающий	ADJ;GEN;PL
усыплять	V;PST;PL
кооператив	N;ACC;PL
автотомия	N;GEN;SG
существующий	ADJ;ACC;NEUT;SG
невозможный	ADJ;GEN;FEM;SG
революционный	ADJ;ACC;FEM;SG
анх	N;INS;SG
весёлый	ADJ;ACC;INAN;PL
зажигательный	ADJ;MASC;SG;LGSPEC1
мельтешить	V;PRS;2;SG
иммигрант	N;DAT;SG
аритмия	N;GEN;PL
вымерший	ADJ;GEN;MASC;SG
вылечивать	V;FUT;2;SG
проституция	N;GEN;SG
категория	N;DAT;PL
резкий	ADJ;FEM;SG;LGSPEC1
удлинённый	ADJ;DAT;MASC;SG
верша	N;ESS;SG
зюйд	N;GEN;PL
самарский	ADJ;ACC;INAN;PL
дзельква пильчатая	N;ESS;SG
аэробный	ADJ;ESS;NEUT;SG
водосток	N;ESS;PL
собственноручный	ADJ;ESS;PL
покуривать	V;PTCP;ACT;PRS
перевес	N;ESS;PL
опухать	V;FUT;1;SG
воздевать	V;IMP;2;PL
ехидна	N;ACC;SG
запоздалый	ADJ;INS;NEUT;SG
диффузия	N;NOM;PL
лесбийский	ADJ;DAT;PL
ругательство	N;DAT;PL
закатный	ADJ;DAT;FEM;SG
ученик	N;INS;SG
приёмо-сдаточный	ADJ;NOM;NEUT;SG
гурт	N;NOM;PL
нуклеотидный	ADJ;ACC;INAN;PL
супермаркет	N;INS;PL
пенис	N;ACC;PL
высушивать	V;CVB;PRS
усыплять	V;PRS;3;PL
динамический	ADJ;INS;NEUT;SG
сестрин	ADJ;INS;NEUT;SG
мистик	N;GEN;PL
профильный	ADJ;MASC;SG;LGSPEC1
биржевой	ADJ;INS;FEM;SG
свояк	N;NOM;PL
внебюджетный	ADJ;ACC;INAN;PL
приступить	V;PST;PL
воин	N;ACC;INAN;PL
пьемонтский	ADJ;GEN;FEM;SG
раскраснеться	V;IMP;2;PL
Пасха	N;ESS;PL
психозотерапия	N;ACC;PL
заселять	V;FUT;1;SG
наполниться	V;PST;PL
луковица	N;GEN;PL
сотворить	V;PTCP;PASS;PST
томный	ADJ;GEN;FEM;SG
ёбаный	ADJ;GEN;MASC;SG
расседаться	V;CVB;PST
шурин	N;INS;PL
меморандум	N;NOM;SG
отводящая мышца	N;NOM;SG
дикий	ADJ;INS;FEM;SG
универсам	N;ESS;PL
маршировать	V;PRS;3;PL
повторяться	V;FUT;3;SG
привесок	N;NOM;PL
сукин сын	N;DAT;SG
орёл	N;ESS;SG
ревизия	N;DAT;PL
запрягать	V;FUT;1;PL
перфект	N;ESS;PL
отражать	V;PRS;2;SG
трёхкомнатный	ADJ;GEN;PL
порошок	N;NOM;SG
переработать	V;FUT;3;PL
самодеятельный	ADJ;GEN;FEM;SG
непродолжительный	ADJ;ESS;FEM;SG
лобковая кость	N;GEN;PL
ультраправый	ADJ;GEN;FEM;SG
доула	N;INS;PL
поучительный	ADJ;ACC;ANIM;PL
оборотный	ADJ;ESS;PL
поволочь	V;PTCP;PASS;PST
сощуриться	V;PTCP;ACT;PST
пишущая машинка	N;GEN;SG
керамика	N;GEN;SG
приветливый	ADJ;INS;PL
операционная система	N;ESS;PL
цюрихский	ADJ;INS;PL
вырабатывать	V;PRS;2;SG
застелить	V;FUT;1;SG
умопомрачительный	ADJ;NOM;FEM;SG
различимый	ADJ;NOM;PL
отяжелеть	V;FUT;2;SG
приморье	N;INS;SG
правительство	N;INS;PL
хромой	ADJ;ESS;MASC;SG
обязаться	V;PTCP;ACT;PST
камера	N;DAT;SG
кошма	N;ACC;PL
абдоминогистеротомия	N;INS;PL
секундант	N;ACC;PL
альтруистка	N;ESS;PL
корякский	ADJ;GEN;FEM;SG
предвидеться	V;PRS;1;PL
накатывать	V;PRS;3;SG
абаданец	N;INS;SG
загрохотать	V;IMP;2;SG
предприняться	V;IMP;2;PL
противовоздушный	ADJ;ACC;NEUT;SG
почесать	V;FUT;2;SG
первая любовь	N;ACC;PL
ежемесячный	ADJ;DAT;NEUT;SG
салон	N;NOM;PL
населённый	V;PTCP;MASC;SG;LGSPEC1
бонбоньерка	N;INS;PL
существительное	N;DAT;PL
рычать	V;PRS;3;SG
красить	V;FUT;3;SG
англо-норманнский	ADJ;INS;PL
прищурить	V;PST;SG;FEM
выковать	V;FUT;1;PL
запад	N;DAT;SG
обнаглеть	V;CVB;PST
ебанутый	ADJ;GEN;PL
ньюсрум	N;INS;SG
замолкать	V;CVB;PRS
компрометирующий	ADJ;ESS;NEUT;SG
огнедышащий	ADJ;DAT;MASC;SG
сочетаемый	ADJ;ACC;FEM;SG
преобразование	N;DAT;SG
заколдованный	V;PTCP;NEUT;SG;LGSPEC1
иностранный	ADJ;ACC;NEUT;SG
вербальный	ADJ;INS;NEUT;SG
мейл	N;NOM;SG
беседа	N;DAT;SG
законный	ADJ;NOM;NEUT;SG
составляющая	N;ACC;SG
утащить	V;FUT;1;SG
буровой	ADJ;ESS;FEM;SG
изначальный	ADJ;NOM;NEUT;SG
дезертир	N;GEN;PL
вершить	V;FUT;1;PL
пятилетний	ADJ;PL;LGSPEC1
рассылать	V;PST;SG;FEM
горизонталь	N;ESS;PL
легкоусвояемый	ADJ;DAT;NEUT;SG
дорожать	V;IMP;2;SG
расправиться	V;FUT;1;SG
оригинальность	N;ESS;SG
сблизить	V;IMP;2;PL
красться	V;FUT;2;PL
безвольный	ADJ;GEN;PL
чёртово колесо	N;DAT;PL
двурукий	ADJ;ACC;NEUT;SG
делегация	N;NOM;SG
благополучный	ADJ;GEN;PL
поспешный	ADJ;MASC;SG;LGSPEC1
указание	N;ESS;SG
выкатить	V;FUT;1;SG
геморрагический	ADJ;ACC;NEUT;SG
компрометирующий	ADJ;ESS;MASC;SG
лаваш	N;DAT;PL
стрельнуть	V;PST;SG;NEUT
антигельминтный	ADJ;ESS;MASC;SG
противоглистный	ADJ;GEN;MASC;SG
редкость	N;ESS;PL
штрих	N;DAT;PL
переваливать	V;PRS;1;SG
отмечаться	V;CVB;PST
самаритянин	N;ACC;PL
флешка	N;ESS;SG
переместиться	V;IMP;2;PL
гюрза	N;GEN;SG
вакханалия	N;NOM;PL
булыжник	N;ESS;SG
оттолкнуться	V;FUT;1;SG
скульптурный	ADJ;GEN;PL
разделительный падеж	N;GEN;SG
осторожный	ADJ;ESS;PL
вдавливать	V;IMP;2;SG
гомонить	V;IMP;2;SG
фонолог	N;ESS;SG
заступаться	V;FUT;2;SG
иерусалимский	ADJ;INS;PL
земляной червь	N;ACC;SG