Accuracy: 0.45199999999999996

Ratio of tags of incorrectly generated inflections: 
N: 0.6783783783783783
ACC: 0.5294117647058824
SG: 0.5017605633802817
ADJ: 0.2968299711815562
NEUT: 0.43529411764705883
LGSPEC1: 0.8387096774193549
DAT: 0.6458333333333334
PL: 0.6260387811634349
NOM: 0.3368421052631579
FEM: 0.31958762886597936
MASC: 0.3130434782608696
V: 0.7050691244239631
FUT: 0.8205128205128205
3: 0.9375
PRS: 0.8805970149253731
1: 0.7407407407407407
ESS: 0.48
IMP: 0.8235294117647058
2: 0.8472222222222222
GEN: 0.48333333333333334
INS: 0.3902439024390244
V.CVB: 0.6666666666666666
PST: 0.48148148148148145
INAN: 0.4642857142857143
V.PTCP: 0.5897435897435898
ACT: 0.47619047619047616
PASS: 1.0
ANIM: 0.03125

Incorrect words: 
галиотис	N;ACC;SG
первобытный	ADJ;NEUT;SG;LGSPEC1
россыпь	N;DAT;PL
представительница	N;NOM;PL
быстрота	N;DAT;SG
пульсар	N;ACC;PL
подвижной	ADJ;ACC;FEM;SG
болтун	N;DAT;PL
купальный халат	N;NOM;PL
средний	ADJ;DAT;MASC;SG
подвесить	V;FUT;3;PL
ускользать	V;PRS;1;SG
проявление	N;ESS;PL
классная доска	N;ESS;PL
разламывать	V;IMP;2;SG
комендант	N;GEN;PL
фарерский	ADJ;INS;NEUT;SG
жаворонок	N;ACC;SG
делишки	N;DAT;SG
дурачиться	V;CVB;PST
взмах	N;GEN;PL
застирать	V;FUT;3;SG
сенатский	ADJ;DAT;MASC;SG
выплачиваться	V;IMP;2;SG
люк фотопулемёта	N;NOM;PL
неловкий	ADJ;NOM;PL
преступный	ADJ;FEM;SG;LGSPEC1
вождение	N;ESS;PL
мадера	N;ACC;PL
мгновение	N;ACC;PL
потрёпанный	ADJ;ACC;INAN;PL
добивать	V;PRS;1;SG
краевой	ADJ;DAT;NEUT;SG
плясать	V;PRS;2;SG
порасти	V;PST;SG;FEM
бомбист	N;ACC;SG
кототерапия	N;GEN;SG
камчатский	ADJ;ACC;INAN;PL
здравомыслие	N;GEN;PL
блондин	N;INS;SG
стекать	V;FUT;2;SG
геральдика	N;INS;SG
гавань	N;ESS;PL
исламофобия	N;ACC;SG
жизнедеятельность	N;INS;SG
подбадривать	V;CVB;PRS
оспаривать	V;FUT;3;PL
парикмахерская	N;GEN;SG
вычислять	V;PST;SG;NEUT
заговориться	V;IMP;2;PL
сухожилие	N;GEN;SG
сильное взаимодействие	N;ESS;SG
погреть	V;FUT;1;SG
опубликовывать	V;PRS;1;SG
присесть	V;PST;SG;FEM
попутешествовать	V;PRS;3;SG
спряжение	N;DAT;PL
Страстной четверг	N;ESS;PL
терменвокс	N;ACC;SG
новодевичий	ADJ;ESS;FEM;SG
котяра	N;DAT;SG
утопленный воздухозаборник	N;INS;SG
пользователь	N;INS;SG
топография	N;ACC;SG
блошиный рынок	N;DAT;SG
проистекать	V;FUT;3;PL
ульяновский	ADJ;NOM;FEM;SG
полиграфический	ADJ;INS;PL
вымышлять	V;PST;PL
костёр	N;ACC;PL
уведомление	N;DAT;PL
преполовение	N;GEN;SG
воронко	N;INS;SG
перевозчик	N;DAT;PL
ковёр	N;INS;SG
присмотр	N;ESS;SG
облик	N;GEN;PL
пускаться	V;FUT;1;PL
раскланиваться	V;FUT;2;PL
умывальня	N;DAT;PL
хантыйский	ADJ;INS;MASC;SG
смазать	V;FUT;2;SG
лысеть	V;PST;SG;MASC
феноменальный	ADJ;NEUT;SG;LGSPEC1
информатизация	N;DAT;PL
взмывать	V;CVB;PRS
благоухать	V;IMP;2;SG
ипподром	N;NOM;PL
древесный уголь	N;NOM;PL
содомизировать	V;FUT;2;SG
морской чёрт	N;ESS;SG
связка	N;DAT;SG
угнетение	N;DAT;PL
втискать	V;IMP;2;SG
волосатый	ADJ;NOM;NEUT;SG
уняться	V;IMP;2;SG
дёргаться	V;PTCP;ACT;PST
кентавр	N;GEN;PL
подкрадываться	V;FUT;2;PL
пропорциональность	N;INS;PL
просочиться	V;FUT;2;PL
промчаться	V;FUT;3;SG
церебральный	ADJ;MASC;SG;LGSPEC1
азиат	N;ESS;PL
вяжущий	ADJ;ACC;FEM;SG
малочисленный	ADJ;NEUT;SG;LGSPEC1
фрезер	N;ESS;PL
ярмо	N;ESS;SG
совок	N;DAT;PL
шухер	N;NOM;PL
стариться	V;IMP;2;PL
тощий	ADJ;ESS;PL
обстрелять	V;FUT;1;PL
выпячивать	V;PRS;1;SG
новорождённый	N;GEN;SG
аванс	N;GEN;PL
вцепиться	V;FUT;1;SG
навёрстывать	V;PST;SG;MASC
невежливый	ADJ;FEM;SG;LGSPEC1
встроенный	ADJ;ACC;INAN;PL
таец	N;GEN;SG
рысак	N;GEN;PL
колодка	N;GEN;PL
объединённый	ADJ;MASC;SG;LGSPEC1
подвёртываться	V;PTCP;ACT;PRS
адамов	ADJ;ACC;INAN;PL
искусственный отбор	N;ESS;PL
мопед	N;ACC;PL
подглядеть	V;FUT;1;PL
приручаться	V;FUT;2;SG
референдум	N;INS;SG
занятой	ADJ;ACC;NEUT;SG
информационно-аналитический	ADJ;INAN;ACC;MASC;SG
оруженосец	N;GEN;SG
хулить	V;PTCP;PASS;PRS
прохаживаться	V;CVB;PRS
напаять	V;PTCP;PASS;PST
прицеплять	V;FUT;3;PL
очарованный кварк	N;GEN;PL
конюх	N;INS;SG
частый	ADJ;GEN;MASC;SG
долбить	V;IMP;2;SG
вдавливаться	V;FUT;2;SG
репортаж	N;ESS;PL
психушка	N;GEN;PL
тун	N;INS;SG
надвинуться	V;PST;SG;NEUT
мерзость	N;DAT;SG
кожаный	ADJ;ESS;PL
существительное	N;ESS;SG
белеть	V;PRS;2;PL
мотыжить	V;PRS;1;PL
подверженный	ADJ;PL;LGSPEC1
искренний	ADJ;NEUT;SG;LGSPEC1
контактная линза	N;ESS;PL
оплачиваться	V;CVB;PST
абазинский	ADJ;ACC;NEUT;SG
представляться	V;FUT;2;PL
книжный магазин	N;ACC;PL
лесохозяйственный	ADJ;ACC;FEM;SG
телеведущий	N;GEN;PL
остолбенеть	V;FUT;2;PL
приключение	N;DAT;PL
цельность	N;INS;PL
плескаться	V;CVB;PRS
чемпионский	ADJ;NOM;NEUT;SG
выскакивать	V;PRS;1;SG
чавкать	V;CVB;PRS
нестабильность	N;GEN;SG
униженный	ADJ;ACC;FEM;SG
люцерна	N;DAT;SG
гостеприимство	N;ESS;SG
замучиться	V;IMP;2;PL
пульт	N;INS;SG
правильный глагол	N;GEN;SG
плакать	V;PRS;3;SG
изобретатель	N;ACC;SG
потылица	N;INS;SG
новаторский	ADJ;INS;PL
чемпионка	N;ACC;PL
цыганёнок	N;GEN;SG
куклёнок	N;DAT;SG
продираться	V;PRS;1;SG
заклёпка	N;ACC;SG
опознавать	V;PRS;2;SG
подноготная	N;DAT;SG
астрономическая единица	N;NOM;SG
гумно	N;GEN;PL
сыскать	V;FUT;3;SG
додумывать	V;PRS;1;SG
богатейший	ADJ;INS;FEM;SG
взлохмачивать	V;FUT;3;SG
уживаться	V;PRS;1;PL
потащиться	V;PTCP;ACT;PST
неотъемлемый	ADJ;ACC;FEM;SG
обмен	N;NOM;PL
напряжённый	V;PTCP;NOM;NEUT;SG
литературовед	N;NOM;PL
прорицатель	N;ACC;SG
запечатлевать	V;PRS;3;SG
чавкать	V;PRS;2;SG
алчность	N;DAT;PL
запихать	V;FUT;2;SG
форменный	ADJ;ACC;FEM;SG
вскипятить	V;PST;SG;FEM
карп	N;GEN;PL
слабоумный	ADJ;DAT;MASC;SG
канистра	N;ACC;SG
открыться	V;IMP;2;PL
молот	N;INS;SG
гулять	V;PRS;2;PL
калкан	N;ACC;SG
почтовый	ADJ;NOM;NEUT;SG
отвестись	V;CVB;PST
спасительный	ADJ;ACC;FEM;SG
усопший	ADJ;ACC;INAN;PL
чёрная дыра	N;ESS;PL
скончаться	V;PST;SG;NEUT
хохотнуть	V;FUT;2;SG
имбирь	N;INS;PL
кончик	N;ACC;PL
растопыривать	V;FUT;1;PL
волшебный	ADJ;ACC;FEM;SG
аллюр	N;INS;PL
царапина	N;ESS;SG
принятие на себя	N;INS;PL
оборониться	V;IMP;2;PL
ненормальный	ADJ;FEM;SG;LGSPEC1
зыбкий	ADJ;ESS;NEUT;SG
антропоморфный	ADJ;MASC;SG;LGSPEC1
саванна	N;NOM;PL
обмыть	V;FUT;2;SG
приёмник воздушного давления	N;ACC;SG
дача	N;DAT;SG
запечатлеть	V;FUT;3;PL
прогрессировать	V;FUT;2;PL
плюхаться	V;PRS;2;SG
бассейновый	ADJ;DAT;MASC;SG
узаконивать	V;CVB;PRS
влюблять	V;PRS;2;SG
расширяться	V;PRS;1;PL
ломтик	N;INS;SG
приземляться	V;PRS;1;PL
южанин	N;ESS;PL
переговариваться	V;PRS;3;PL
радиолокационный дальномер	N;ESS;PL
благоустраивать	V;PTCP;PASS;PRS
слухи	N;GEN;SG
бухгалтерская книга	N;NOM;PL
взор	N;DAT;PL
очевидец	N;ESS;PL
македонский	ADJ;INS;PL
авиапредприятие	N;ESS;SG
противопоставлять	V;IMP;2;PL
конский	ADJ;DAT;NEUT;SG
обостриться	V;IMP;2;PL
сумасшествовать	V;FUT;1;PL
праща	N;ESS;SG
раскраснеться	V;FUT;3;PL
десант	N;DAT;PL
делить	V;IMP;2;SG
шрам	N;INS;PL
высказаться	V;PTCP;ACT;PST
кабестан	N;ESS;SG
смотреться	V;PRS;3;SG
почуять	V;PST;PL
прикинуться	V;FUT;1;PL
ударный инструмент	N;ACC;PL
организация	N;GEN;SG
цесаревич	N;INS;SG
модуль	N;DAT;SG
мытый	ADJ;MASC;SG;LGSPEC1
обернуть	V;PST;PL
перевёртываться	V;IMP;2;PL
сдёрнуть	V;FUT;2;PL
тулий	N;INS;SG
хмурить	V;FUT;2;PL
каминг-аут	N;NOM;PL
сердить	V;PST;PL
оплести	V;PST;SG;MASC
сердить	V;PST;SG;MASC
затылок	N;NOM;PL
имущество	N;GEN;SG
британка	N;ACC;PL
прибавить	V;PST;PL
гибрид	N;ACC;INAN;PL
монархический	ADJ;NOM;NEUT;SG
разрешиться	V;FUT;1;SG
серный	ADJ;NOM;FEM;SG
ринг	N;DAT;PL
серо-буро-малиновый	ADJ;ANIM;ACC;MASC;SG
водокачка	N;INS;SG
женить	V;PTCP;PASS;PST
нейтралитет	N;INS;PL
арменистика	N;ACC;SG
травма	N;ACC;PL
расходовать	V;FUT;3;PL
нацеливать	V;FUT;2;SG
привязь	N;DAT;PL
коррупционер	N;INS;PL
порнография	N;DAT;PL
усложнение	N;GEN;SG
хулиганить	V;CVB;PRS
покоиться	V;PTCP;ACT;PRS
намотать	V;IMP;2;SG
швеллер	N;ESS;PL
засаживать	V;CVB;PRS
порыв	N;ESS;PL
инфинитив	N;GEN;PL
последний	ADJ;DAT;PL
угоститься	V;FUT;2;PL
излишний	ADJ;INS;MASC;SG
пьеса	N;GEN;PL
перископ	N;ESS;PL
бессовестный	ADJ;DAT;MASC;SG
зарубать	V;PTCP;PASS;PRS
знакомство	N;ESS;PL
ост	N;NOM;PL
обзывать	V;PRS;1;SG
килька	N;GEN;SG
японец	N;GEN;SG
обзаводиться	V;PRS;3;PL
сжиматься	V;FUT;3;PL
полонянин	N;ESS;SG
архимедов	ADJ;DAT;MASC;SG
объявление	N;DAT;PL
буддист	N;ACC;PL
машинно-читаемый словарь	N;GEN;SG
переменять	V;PTCP;ACT;PRS
диез	N;GEN;PL
лист Мёбиуса	N;ESS;SG
славиться	V;PTCP;ACT;PST
тщиться	V;PST;SG;NEUT
безусловный	ADJ;NEUT;SG;LGSPEC1
насчитываться	V;IMP;2;PL
джокер	N;ACC;INAN;PL
щекотать	V;PRS;1;PL
перестраиваться	V;CVB;PST
селянин	N;NOM;PL
корейский	ADJ;DAT;MASC;SG
заглядывать	V;PST;SG;MASC
аншлаг	N;ESS;PL
засомневаться	V;PST;SG;MASC
НЭП	N;GEN;SG
родимое пятно	N;NOM;PL
мужеложеский	ADJ;DAT;MASC;SG
девица	N;DAT;SG
ислам	N;INS;PL
невыразимый	ADJ;FEM;SG;LGSPEC1
столпиться	V;FUT;3;SG
абстинентный синдром	N;GEN;SG
сместиться	V;PST;SG;NEUT
кликун	N;INS;SG
воспротивиться	V;FUT;1;PL
уполномочивать	V;FUT;1;PL
купля	N;ACC;SG
быстрый	ADJ;ESS;FEM;SG
брякать	V;FUT;1;SG
поддельный	ADJ;MASC;SG;LGSPEC1
осведомлять	V;FUT;1;PL
военторг	N;GEN;PL
вонзиться	V;FUT;1;SG
ограждать	V;PTCP;PASS;PRS
замысел	N;ESS;SG
днюха	N;NOM;PL
пригнуться	V;IMP;2;SG
тяжелобомбардировочный	ADJ;GEN;MASC;SG
Лхаса	N;GEN;SG
подворотня	N;ACC;SG
морозный	ADJ;FEM;SG;LGSPEC1
вложить	V;IMP;2;SG
мартышка	N;INS;SG
опарыш	N;GEN;PL
обивать	V;FUT;2;SG
теснить	V;FUT;3;PL
гастроль	N;ESS;PL
продаться	V;FUT;1;SG
возница	N;ESS;SG
сбережение	N;NOM;PL
натуга	N;DAT;SG
поговаривать	V;PRS;3;PL
размышлять	V;PRS;3;SG
ведьма	N;ESS;SG
этиология	N;GEN;SG
зрительский	ADJ;ACC;FEM;SG
распределённый	V;PTCP;ESS;MASC;SG
прощальный	ADJ;FEM;SG;LGSPEC1
съехаться	V;FUT;2;PL
корейский язык	N;GEN;SG
клумба	N;ESS;SG
отваливать	V;CVB;PRS
асинхронный	ADJ;DAT;NEUT;SG
маскировка	N;GEN;PL
эрзянский	ADJ;ACC;FEM;SG
брить	V;PRS;1;PL
новоселье	N;DAT;PL
продлить	V;FUT;1;PL
ограда	N;GEN;PL
барон	N;ACC;SG
абстинент	N;INS;PL
грузинский	ADJ;DAT;MASC;SG
грудная клетка	N;ACC;PL
кроить	V;PRS;2;SG
дополнительный	ADJ;FEM;SG;LGSPEC1
новоиспечённый	ADJ;NEUT;SG;LGSPEC1
завершаться	V;PRS;3;PL
сумасшествие	N;INS;SG
ускориться	V;IMP;2;PL
чокнуться	V;CVB;PST
струп	N;INS;SG
применимый	ADJ;FEM;SG;LGSPEC1
оптимист	N;DAT;PL
опаливать	V;PTCP;PASS;PRS
приближать	V;PRS;3;SG
сторонник	N;DAT;PL
усыплять	V;PST;PL
кооператив	N;ACC;PL
автотомия	N;GEN;SG
существующий	ADJ;ACC;NEUT;SG
сейл	N;INS;SG
революционный	ADJ;ACC;FEM;SG
анх	N;INS;SG
весёлый	ADJ;ACC;INAN;PL
зажигательный	ADJ;MASC;SG;LGSPEC1
аритмия	N;GEN;PL
вымерший	ADJ;GEN;MASC;SG
вылечивать	V;FUT;2;SG
проституция	N;GEN;SG
категория	N;DAT;PL
резкий	ADJ;FEM;SG;LGSPEC1
удлинённый	ADJ;DAT;MASC;SG
верша	N;ESS;SG
зюйд	N;GEN;PL
самарский	ADJ;ACC;INAN;PL
дзельква пильчатая	N;ESS;SG
водосток	N;ESS;PL
покуривать	V;PTCP;ACT;PRS
перевес	N;ESS;PL
ехидна	N;ACC;SG
ругательство	N;DAT;PL
приёмо-сдаточный	ADJ;NOM;NEUT;SG
гурт	N;NOM;PL
нуклеотидный	ADJ;ACC;INAN;PL
супермаркет	N;INS;PL
пенис	N;ACC;PL
высушивать	V;CVB;PRS
усыплять	V;PRS;3;PL
динамический	ADJ;INS;NEUT;SG
сестрин	ADJ;INS;NEUT;SG
поездной	ADJ;ESS;NEUT;SG
мистик	N;GEN;PL
профильный	ADJ;MASC;SG;LGSPEC1
свояк	N;NOM;PL
внебюджетный	ADJ;ACC;INAN;PL
приступить	V;PST;PL
воин	N;ACC;INAN;PL
раскраснеться	V;IMP;2;PL
Пасха	N;ESS;PL
психозотерапия	N;ACC;PL
наполниться	V;PST;PL
луковица	N;GEN;PL
сотворить	V;PTCP;PASS;PST
ёбаный	ADJ;GEN;MASC;SG
расседаться	V;CVB;PST
шурин	N;INS;PL
дикий	ADJ;INS;FEM;SG
универсам	N;ESS;PL
маршировать	V;PRS;3;PL
блок	N;ESS;PL
привесок	N;NOM;PL
сукин сын	N;DAT;SG
орёл	N;ESS;SG
ревизия	N;DAT;PL
запрягать	V;FUT;1;PL
перфект	N;ESS;PL
переработать	V;FUT;3;PL
лобковая кость	N;GEN;PL
поволочь	V;PTCP;PASS;PST
сощуриться	V;PTCP;ACT;PST
пишущая машинка	N;GEN;SG
керамика	N;GEN;SG
операционная система	N;ESS;PL
вырабатывать	V;PRS;2;SG
застелить	V;FUT;1;SG
отяжелеть	V;FUT;2;SG
обязаться	V;PTCP;ACT;PST
камера	N;DAT;SG
кошма	N;ACC;PL
абдоминогистеротомия	N;INS;PL
секундант	N;ACC;PL
предвидеться	V;PRS;1;PL
накатывать	V;PRS;3;SG
абаданец	N;INS;SG
загрохотать	V;IMP;2;SG
предприняться	V;IMP;2;PL
противовоздушный	ADJ;ACC;NEUT;SG
почесать	V;FUT;2;SG
первая любовь	N;ACC;PL
ежемесячный	ADJ;DAT;NEUT;SG
салон	N;NOM;PL
населённый	V;PTCP;MASC;SG;LGSPEC1
существительное	N;DAT;PL
рычать	V;PRS;3;SG
красить	V;FUT;3;SG
выковать	V;FUT;1;PL
ньюсрум	N;INS;SG
замолкать	V;CVB;PRS
компрометирующий	ADJ;ESS;NEUT;SG
огнедышащий	ADJ;DAT;MASC;SG
сочетаемый	ADJ;ACC;FEM;SG
преобразование	N;DAT;SG
заколдованный	V;PTCP;NEUT;SG;LGSPEC1
иностранный	ADJ;ACC;NEUT;SG
беседа	N;DAT;SG
законный	ADJ;NOM;NEUT;SG
составляющая	N;ACC;SG
утащить	V;FUT;1;SG
дезертир	N;GEN;PL
вершить	V;FUT;1;PL
горизонталь	N;ESS;PL
легкоусвояемый	ADJ;DAT;NEUT;SG
дорожать	V;IMP;2;SG
расправиться	V;FUT;1;SG
оригинальность	N;ESS;SG
сблизить	V;IMP;2;PL
чёртово колесо	N;DAT;PL
двурукий	ADJ;ACC;NEUT;SG
поспешный	ADJ;MASC;SG;LGSPEC1
выкатить	V;FUT;1;SG
геморрагический	ADJ;ACC;NEUT;SG
компрометирующий	ADJ;ESS;MASC;SG
лаваш	N;DAT;PL
редкость	N;ESS;PL
штрих	N;DAT;PL
переваливать	V;PRS;1;SG
отмечаться	V;CVB;PST
самаритянин	N;ACC;PL
флешка	N;ESS;SG
переместиться	V;IMP;2;PL
гюрза	N;GEN;SG
булыжник	N;ESS;SG
оттолкнуться	V;FUT;1;SG
разделительный падеж	N;GEN;SG
вдавливать	V;IMP;2;SG
гомонить	V;IMP;2;SG
заступаться	V;FUT;2;SG
босанский	ADJ;DAT;FEM;SG
земляной червь	N;ACC;SG